[tile key]
0 - empty
1 - ceiling_tile.png
2 - wall_tile.png
3 - floor_tile.png
[level map]
1111111111111111111111111111111111111111111111111
1222222222212222222212211112222222222222222222221
1333333333313333333313311113333333333333333333331
1333333333313111113313311111111111111111111133331
1333333333313122223313322222222222222222222233331
1333333333313133333313333333333333333333333333331
1333333333313133333333333333333333333333333333331
1111113111113331111111111111111111111111111111111
2222223221113332222222222222222222222222222222221
3333333333333333333333333333333333333333333333331
3333333133333333333333333333333333333333333333331
1111133111113311111113311111111113311111111113311
1111133111113311111113311111112223311111111113311
1111133111113311111113311111113333111111111223111
1111133111113311111111322111123311111111112333111
1111233211113311111111333211233111111111123311111
1112333321113311111111113322331111111111233111111
1113333331113322221111111333311111111112333111111
1113333331113333331111111133111111111123313211111
1113333331113311331111111133111111111233113321111
1113333331113311331111111133111111112331111332111
1223111111113322331111111133111111123311111133211
1333111111113333331111111133111111233111111123321
1333111111113333331111111133111112331111111133331
1333111111223311111111111133111223311111111133331
1333111111333311111112222233111333111111111133331
1333111111333311122223333333111333111111111113311
1333111111333311133333333333111111111111111223321
1111111111133111111113333333111111111111112333331
1222222222233111111113333333111111111111123333331
1333333333333111111111111111111111111111233333311
1333333333333111111111111111111111111112333333111
1111111111111111111111111111122222222223333333111
1111111111111111111122222222233333333333333313111
1111111111122222222233333333333333333333333113111
1111112222233333333333333333333333333333331113111
1222223333333333333333333333333333333333311113111
1333333333333333111111113333333333333333111113111
1333333333333333111111113333333333333331111113111
1333333333333333111111113333333333333311111113111
1333333333333333222222223333333333333111111113111
1333333333333333333333333333333333331111111113111
1333333333333333333333333333333333311111111113111
1333333333333333333333333333333333111111111113111
1111111111111111111111111111111111111111111113111
1111111111111111111111111111111111111111111113111
1111111111111111111111111111111111111111111123211
1111111111111111111111111111111111111111111133311
1111111111111111111111111111111111111111111133311
1111111111111111111111111111111111111111111111111
[objects/script triggers]

